Date Added;Traveler;Rosetta Project;DGS Report;Imagesets In Rosetta;Imagesets in IDX;Imagesets in Both;Imagesets No Workflows;Count
2020-05-19 20:20:07;[19-0198|http://rosettaprod-app01.a.fsglobal.net:8081/teamworks/source?project=19-0198];Indiana, County Marriages, 1811-2007 - FSI;[Report|19-0198 DgsMisassignments];0;3;19;0;22
2020-05-29 18:12:57;[19-0394|http://rosettaprod-app01.a.fsglobal.net:8081/teamworks/source?project=19-0394];Missouri, Missouri State Archives, Pre-WWII Adjutant General Enlistment Contracts, 1900-1941 - FSI (RE-INDEXING);[Report|19-0394 DgsMisassignments];0;0;122;0;122
2020-05-19 19:14:11;[19-1285|http://rosettaprod-app01.a.fsglobal.net:8081/teamworks/source?project=19-1285];Washington, County Death Registers, 1881-1922 - FSI;[Report|19-1285 DgsMisassignments];9;0;39;0;48
2020-05-19 19:14:11;[16-1180|http://rosettaprod-app01.a.fsglobal.net:8081/teamworks/source?project=16-1180];Wales, National Library of Wales Marriage Bonds, 1564-1900 - FSI;[Report|16-1180 DgsMisassignments];44;0;18;0;62
2020-05-19 20:20:07;[09-0544|http://rosettaprod-app01.a.fsglobal.net:8081/teamworks/source?project=09-0544];Sri Lanka, Colombo District Dutch Reformed Baptisms and Marriages, 1677-1810;[Report|09-0544 DgsMisassignments];0;0;2;0;2
2020-05-19 19:14:11;[19-1525|http://rosettaprod-app01.a.fsglobal.net:8081/teamworks/source?project=19-1525];England, Herefordshire Bishop's Transcripts (pre-1754), 1583-1754 - FSI;[Report|19-1525 DgsMisassignments];3;0;0;0;3
2020-05-19 20:20:07;[19-0115|http://rosettaprod-app01.a.fsglobal.net:8081/teamworks/source?project=19-0115];NARA, Illinois, Naturalization Records, 1856-1991, indexed (Child: United States, Naturalization And Citizenship, 1856-1991) - Capture;[Report|19-0115 DgsMisassignments];0;1;0;0;1
2020-05-19 20:20:07;[19-0313|http://rosettaprod-app01.a.fsglobal.net:8081/teamworks/source?project=19-0313];Brazil, Paraná, Civil Registration, 1852-1996 - FSI;[Report|19-0313 DgsMisassignments];0;0;170;0;170
2020-05-19 20:20:07;[19-0732|http://rosettaprod-app01.a.fsglobal.net:8081/teamworks/source?project=19-0732];New York City, World War II Draft Registration Cards,1940-1947 (NARA) - FSI;[Report|19-0732 DgsMisassignments];0;0;1;0;1
2020-05-29 18:32:37;[16-0750|http://rosettaprod-app01.a.fsglobal.net:8081/teamworks/source?project=16-0750];Sweden, Jönköping, Church Records to 1860 - Part 3 - FSI;[Report|16-0750 DgsMisassignments];1;0;0;0;1
2020-05-19 20:20:07;[17-0814|http://rosettaprod-app01.a.fsglobal.net:8081/teamworks/source?project=17-0814];Philippines, National Offices, Civil Registration of Deaths, 1945-1986 - FSI;[Report|17-0814 DgsMisassignments];0;0;23;0;23
2020-05-19 20:20:07;[14-0257|http://rosettaprod-app01.a.fsglobal.net:8081/teamworks/source?project=14-0257];Italy, Verbano-Cusio-Ossola, Civil Registration, Births, 1875-1899 (DGA Project) - FSI;[Report|14-0257 DgsMisassignments];1;9;0;0;10
2020-05-19 20:20:07;[18-1174|http://rosettaprod-app01.a.fsglobal.net:8081/teamworks/source?project=18-1174];Colombia, Catholic Church Records, 1693-2010 - FSI/DB for FSI Support;[Report|18-1174 DgsMisassignments];0;0;19;0;19
2020-05-19 20:20:07;[17-1602|http://rosettaprod-app01.a.fsglobal.net:8081/teamworks/source?project=17-1602];Argentina, Corrientes, Registro Civil, 1880-1960 - (Capture/FSI/DB for FSI Support);[Report|17-1602 DgsMisassignments];0;0;400;0;400
2020-05-19 19:14:11;[18-0086|http://rosettaprod-app01.a.fsglobal.net:8081/teamworks/source?project=18-0086];Wales, National Library of Wales Marriage Bonds, 1564-1900 - FSI;[Report|18-0086 DgsMisassignments];1;0;18;0;19
2020-05-19 20:20:07;[16-0614|http://rosettaprod-app01.a.fsglobal.net:8081/teamworks/source?project=16-0614];Paraguay, Catholic Church Records, 1772-1978 - FSI;[Report|16-0614 DgsMisassignments];0;0;5;0;5
2020-05-19 20:20:07;[17-0410|http://rosettaprod-app01.a.fsglobal.net:8081/teamworks/source?project=17-0410];Brazil, Sao Paulo, Civil Registration, 1907-1995, FSI;[Report|17-0410 DgsMisassignments];0;26;270;0;296
2020-05-19 20:20:07;[17-0553|http://rosettaprod-app01.a.fsglobal.net:8081/teamworks/source?project=17-0553];Pennsylvania, World War II Draft Registrations, 1940-1945 - IDX;[Report|17-0553 DgsMisassignments];0;0;200;0;200
2020-05-19 20:20:07;[14-1781|http://rosettaprod-app01.a.fsglobal.net:8081/teamworks/source?project=14-1781];Switzerland, Fribourg, Census, 1880 (German Content) - FSI;[Report|14-1781 DgsMisassignments];0;5;17;0;22
2020-05-19 20:20:07;[16-0019|http://rosettaprod-app01.a.fsglobal.net:8081/teamworks/source?project=16-0019];Dominican Republic, Civil Registration, Deaths, 1838-2015 - FSI;[Report|16-0019 DgsMisassignments];3;396;0;0;399
2020-05-19 20:20:07;[10-0631|http://rosettaprod-app01.a.fsglobal.net:8081/teamworks/source?project=10-0631];Croatia, Delnice Roman Catholic Deanery Church Books, 1571-1926, pt. 1 - FSI;[Report|10-0631 DgsMisassignments];0;0;9;0;9
2020-05-19 20:20:07;[17-0030|http://rosettaprod-app01.a.fsglobal.net:8081/teamworks/source?project=17-0030];United States, State and County Marriages, 1700-2005-FSI (Multicollection)- Part 4 (FMP);[Report|17-0030 DgsMisassignments];6;2;101;0;109
2020-05-19 20:20:07;[18-1017|http://rosettaprod-app01.a.fsglobal.net:8081/teamworks/source?project=18-1017];Chile, Cemetery Records, 1800-2015 - FSI/DB for FSI Support;[Report|18-1017 DgsMisassignments];0;0;28;0;28
2020-05-19 20:20:07;[15-1337|http://rosettaprod-app01.a.fsglobal.net:8081/teamworks/source?project=15-1337];United States, New York, New York Naturalization Records, U.S. District Court - Southern District (NARA) 1824-1946 - FSI;[Report|15-1337 DgsMisassignments];0;0;7;0;7
2020-05-19 14:42:19;[18-1931|http://rosettaprod-app01.a.fsglobal.net:8081/teamworks/source?project=18-1931];Philippines, Marriage Records, 1945-1987 - FSI;[Report|18-1931 DgsMisassignments];1;176;438;0;615
2020-05-19 20:20:07;[20-0012|http://rosettaprod-app01.a.fsglobal.net:8081/teamworks/source?project=20-0012];England, Lancashire Non-Conformist Church Records, 1647-1996 - FSI;[Report|20-0012 DgsMisassignments];0;0;1;0;1
2020-05-19 20:20:07;[11-0709|http://rosettaprod-app01.a.fsglobal.net:8081/teamworks/source?project=11-0709];Panama, Catholic Church Records, Part 1, FSI;[Report|11-0709 DgsMisassignments];0;1;134;0;135
2020-05-19 20:20:07;[19-1099|http://rosettaprod-app01.a.fsglobal.net:8081/teamworks/source?project=19-1099];Italy, Bologna, Civil Registration, 1806-1899 (DGA Project) - FSI;[Report|19-1099 DgsMisassignments];0;296;154;0;450
2020-05-19 20:20:07;[20-0014|http://rosettaprod-app01.a.fsglobal.net:8081/teamworks/source?project=20-0014];Washington, County Birth Registers (Part II), 1881-1922 - FSI;[Report|20-0014 DgsMisassignments];9;0;39;0;48
2020-05-19 20:20:07;[19-0560|http://rosettaprod-app01.a.fsglobal.net:8081/teamworks/source?project=19-0560];Spain, Province of Gerona, Municipal Records, 1717-1970 - FSI/DB for FSI Support;[Report|19-0560 DgsMisassignments];52;0;1;0;53
2020-05-19 20:20:07;[16-1555|http://rosettaprod-app01.a.fsglobal.net:8081/teamworks/source?project=16-1555];England, Northumberland Parish Registers, 1538-2012 - FSI;[Report|16-1555 DgsMisassignments];0;15;0;0;15
2020-05-19 20:20:07;[16-1335|http://rosettaprod-app01.a.fsglobal.net:8081/teamworks/source?project=16-1335];Guatemala, RENAP, Civil Registration, 1885-2009, FSI;[Report|16-1335 DgsMisassignments];0;1;28;0;29
2020-05-19 20:20:07;[16-0006|http://rosettaprod-app01.a.fsglobal.net:8081/teamworks/source?project=16-0006];Venezuela, Caracas, Catholic Church Records, 1578-1947 - FSI;[Report|16-0006 DgsMisassignments];0;0;10;0;10
2020-05-19 20:20:07;[19-0307|http://rosettaprod-app01.a.fsglobal.net:8081/teamworks/source?project=19-0307];England, Northumberland Non-Conformist Church Records, 1613-1920 - FSI;[Report|19-0307 DgsMisassignments];1;0;1;0;2
2020-06-16 20:25:00;[13-1290|http://rosettaprod-app01.a.fsglobal.net:8081/teamworks/source?project=13-1290];Nicaragua, Civil Registration, 1809-2013 - FSI/DB for FSI Support;[Report|13-1290 DgsMisassignments];12;0;0;0;12
2020-06-17 18:18:09;[20-0816|http://rosettaprod-app01.a.fsglobal.net:8081/teamworks/source?project=20-0816];Texas, Hardin County Clerk, Death Records, 1908-1948 - FSI;[Report|20-0816 DgsMisassignments];1;0;0;0;1
2020-05-19 20:20:07;[16-1097|http://rosettaprod-app01.a.fsglobal.net:8081/teamworks/source?project=16-1097];Michigan, Michigan State Archives, Naturalization records, 1812-1985 -  FSI/DB (for Indexing Support);[Report|16-1097 DgsMisassignments];1;0;0;0;1
2020-07-08 18:39:39;[19-0246|http://rosettaprod-app01.a.fsglobal.net:8081/teamworks/source?project=19-0246];France, Haute-Vienne, Census, 1836 - FSI;[Report|19-0246 DgsMisassignments];0;4;0;0;4
2020-05-19 20:20:07;[14-0840|http://rosettaprod-app01.a.fsglobal.net:8081/teamworks/source?project=14-0840];Newsbank Obituaries, 1980-2014, Post MOU - Image Ingest & FSI/DB;[Report|14-0840 DgsMisassignments];0;8;0;0;8
2020-05-19 20:20:07;[14-0365|http://rosettaprod-app01.a.fsglobal.net:8081/teamworks/source?project=14-0365];Switzerland, Fribourg, Census, 1811-1880 - 1880 Census - FSI;[Report|14-0365 DgsMisassignments];0;0;17;0;17
2020-05-19 14:42:19;[14-0267|http://rosettaprod-app01.a.fsglobal.net:8081/teamworks/source?project=14-0267];Italy, Mantova, Civil Registration, 1866-1903 (DGA Project), part 2 - FSI;[Report|14-0267 DgsMisassignments];0;0;212;0;212
2020-05-19 20:20:07;[11-1473|http://rosettaprod-app01.a.fsglobal.net:8081/teamworks/source?project=11-1473];Czech Republic, Litomerice State Regional Archive Church Records 1552-1948, pt. 2 - FSI;[Report|11-1473 DgsMisassignments];0;0;35;0;35
2020-09-11 21:37:03;[20-1081|http://rosettaprod-app01.a.fsglobal.net:8081/teamworks/source?project=20-1081];Illinois, Military Discharge Records, ca.1862 - ca.1965 - FSI;[Report|20-1081 DgsMisassignments];1;0;0;0;1
2020-05-19 20:20:07;[14-0120|http://rosettaprod-app01.a.fsglobal.net:8081/teamworks/source?project=14-0120];Philippines, Camarines Sur, Archdiocese of Caceres, Parish Registers, 1716-1977 - FSI;[Report|14-0120 DgsMisassignments];0;9;0;0;9
2020-05-19 20:20:07;[18-1488|http://rosettaprod-app01.a.fsglobal.net:8081/teamworks/source?project=18-1488];United States, Enlisted and Officer Muster Rolls and Rosters, 1916-1939 (NARA 85713803) - Capture/FSI;[Report|18-1488 DgsMisassignments];0;87;12;0;99
